8 5 1
@@@@@
@C.@@
@...@
@@..@
@.@.@
@...@
@...@
@K@@@