5 8 2
@@@@@@@@
@@@@@..|
@.....@@
..@@@@@@
......K@
K....@@@
@.....@@
@@@..@@@
@...@@@@
@@....C@